_________________________________________________
|           |           |           |           |
|     9     |    10     |     11    |     12    |
|    0,2    |   1,2     |    2,2    |    3,2    |
|___________|___________|___________|___________|
|           |           |           |           |
|     5     |     6     |     7     |     8     |
|    0,1    |    1,1    |    2,1    |    3,1    |
|___________|___________|___________|___________|
|           |           |           |           |
|     1     |     2     |     3     |     4     |
|    0,0    |    1,0    |    2,0    |    3,0    |
|___________|___________|___________|___________|

